#################+#################
#            #F  A  F#            #
#                                 #
#            #FFFFFFF#            #
#      FFF       C      FFF       #
#           V#FFFFFFF#V           #
#                H                #
#            #FFFFFFF#            #
#      FFF       P      FFF       #
#            #FFFFFFF#            #
#                                 #
#################-#################