###################################
#                I                #
#                I                #
# FFFFF   FFF ####### FF   FFFFFF #
#                #                #
#   ##########   #   ##########   #
#                #                #
+A               #                -
#                #               F#
#                #                #
#       S        #       C        #
###################################