###################################
#              gCG                #
#          ###     ###            #
#             #####               #
#     F        g#G        F       #
-     F        g#G        F      A+
#     F        g#G        F       #
#     F        g#G        F       #
#             #####               #
#          ###     ###            #
#              gPG                #
###################################