###################################
+A  #   # # # #     #####     #####
# #   # # # # # #   # # #    F# # #
# # # # # # # # ### # # # ### # # #
# # #   #     #   #     # #       #
# ### ### ### ##### ### # # ### ###
#   #     #     #   # # #     #   #
### # ### ### ### ### # ##### # # #
#   # # #   #     #   #       # # #
#C#   # ### # ##### ### ### ##### #
### #   ####   ###F  ###  ####    -
###################################


